111111111
1P00000P1
1C00000C1
1000E0001
111111111