11111111111111111111111
100000000000100010001E1
11111101101010101011101
1P100100101011100010001
10101111101000001110111
101000000011110110001C1
10111111101000000011101
10000000101011111110001
10101110001000000000111
101010001000111110101C1
10111000100001001110101
10100010101111000100101
11111110101001010111101
1C000000100000010000001
11111111111111111111111