111111111
1P0000001
100000001
1000E0001
111111111