111111111
1P0000001
1C00000C1
100000001
111111111