111111111
100000001
1C00000C1
1E0000001
111111111