111111111
1P0000000
1C00000C1
1000E0001
111111111