111111111
1P0000001
1C00000C1
1OOOEOOO1
111111111